R 800 400
NO ./textures/tex_wall_N.xpm
SO ./textures/tex_wall_S.xpm
WE ./textures/tex_wall_W.xpm
EA ./textures/tex_wall_E.xpm
S ./textures/evee.xpm
F 255,255,255
C 1,1,1
11111111111111111111111111111111111
10000000000000002020000000000000001
10000000000000000000000000000000001
10000000000111111111111100000000000
10000000000000000000000000000000001
10000000000000000000000000000000001
10000000000000000000000000000000001
10000000000000000S00000000000000001
10000000000000000000000000000000001
10000000000000000000000000000000001
10000000000000000000000000000000001
11111111111111111111111111111111111
