R 800 400
NO ./textures/tex_wall_1.xpm
SO ./textures/tex_wall_2.xpm
EA ./textures/tex_wall_3.xpm
WE ./textures/tex_wall_4.xpm
S ./textures/evee.xpm
F 255,255,255
C 1,1,1
11111111111111111111111111111111111111111111111111
12000000000000000000000000000000000000000000000001
10000000000000000000000011111000000000000000022001
10000000000000000000000000000000000000000000222001
10000000000000000000000000S00000000000000000022001
12000000000000000000000000000000000000000000000001
11111111111111111111111111111111111111111111111111
